###################################
#                            ^   E#
#                            ######
#####                             #
# < |                = #          #
########################^##########
#                                 #
#                                 #
#<     ##                         #
######  ##                        #
#        ##                       #
#         ##                      #
#          ## +                  ##
#############################X#####
#                                 #
#                                 #
##               .              `##
###                             ###
#####  H                *     #####
###################################