###################################
#                            XXXXE#
#                            XXXXE#
#                            ######
#                                 #
#                                 #
#                                 #
#                                 #
#####            .                #
#                                 #
#                                 #
#                                 #
#                               ###
#                             ##  #
#                           ##    #
#                         ##      #
#                       ##        #
#     H               ##          #
###################################