###################################
#                            X   E#
#                            ######
#                                 #
#                                 #
#                                 #
#          H                      #
# `                               #
#####            .                #
#                                 #
#                                 #
#                                 #
#                               T #
#                               ###
#                             ##  #
#                           ##    #
#                         ##      #
#                       ##        #
#                     ##          #
###################################