###################################
#E  ^            <                #
#####           ###               #
#                                 #
#                                 #
#                                 #
#                                 #
#                                 #
#                                 #
#                                 #
#                                 #
#                                 #
###############X###################
######                            #
#`  |                            =#
######          .                ##
#                                 #
#                                 #
#  H                              #
###################################