###################################
#                            X   E#
#                            ######
#                                 #
#                                 #
#                                 #
#                                 #
# `                               #
#####                             #
#                                 #
#                                 #
#H                                #
#                                <#
#                               ###
#                             ##  #
#                           ##    #
#                         ##      #
#^#                     ##        #
#.|                   ##          #
###################################