###################################
#                                 #
#                                 #
#                            ######
#                                 #
#                                 #
#                                 #
#                                 #
#####                             #
#                                 #
#                                 #
#                                 #
#                               ###
#                             ##  #
#                           ##    #
#                         ##      #
#                       ##        #
#                     ##          #
###################################