###################################
#                            X  HE#
#                            ######
#                                 #
#                                 #
#                                 #
#                                 #
# `                               #
#####            .                #
#                                 #
#                                 #
#                                 #
#                                 #
#                               ###
#                             ##  #
#                           ##    #
#                         ##      #
#                       ##        #
#                     ##          #
###################################