###################################
#                            X   E#
#                            ######
#                                 #
#                                 #
#                                 #
#                                 #
# `                               #
#####            .                #
#                                 #
#                                 #
#                                 #
#                                 #
#                               ###
#                             ##  #
#                           ##    #
#                         ##      #
#                       ##        #
#    H                ##     +    #
###################################