##############################
#                            #
#                            #
#                       ######
#                            #
#                            #
#                            #
#                            #
#####                        #
#                            #
#                            #
#                            #
#                          ###
#                        ##  #
#                      ##    #
#                    ##      #
#                  ##        #
#                ##          #
##############################