###################################
#                            X   E#
#                            ######
###################################
#                                 #
#                                 #
#                                 #
#                                 #
#                                 #
#                                 #
#                                 #
#                                 #
#        =                   `    #
###############################X###
#                                 #
#                                 #
##               .              `##
###                             ###
#####  H                =     #####
###################################