###################################
#                                E#
#                            ######
#######                           #
# <   |           = #             #
########################^##########
#                                 #
#     ##                          #
#<     ##                         #
######  ##                        #
#        ##                       #
#         ##                      #
#          ## +                  ##
#############################X#####
#                                 #
#                                 #
##               .              `##
###                             ###
#####  H                *     #####
###################################